111111111111111111111
100000000001000000001
111001111101000111001
110000000001001100001
100111111001001100001
100000000000001000001
101111111100011010001
101000000000011010001
101000101110001010111
101000000010101000001
101000000010000011111
100011100011111100001
100000001000000000001
111111111000011111001
100000000000100001001
101111111111001101011
100100000000011001001
110100111111111000101
100101000000000001001
101101010111111111101
100001000000000000001
111111111111111111111