111111111111111111111
100000000001000000001
111011111101000111001
110000000001001100001
100111111001001100001
100000000000001000001
101111111100011010001
101000000000011010001
101001101110001010111
101001000010101000001
101000000010000011111
100011110111111100001
100000000000000000001
111111111000011111001
100000000000100001001
101111111111001101011
100100000000011001001
110100011111111000101
100101110000000001001
101101010111111111101
100001000000000000001
111111111111111111111