111111111111111111111
100000000001000000001
111011111001000111001
110000011001001100001
100111111001000100001
100000000000000100001
101111111100011100001
101001000000011110001
101001001110001110111
101001000010001000001
101000000010000000001
100011110111111111111
100000000000000000001
111111111000011111001
100000000000100001001
101111111111001001001
100100000000010000101
110100011111110000101
100101110000000000101
101101000111111111101
100001000000000000001
111111111111111111111